NO ./textures/brick_wall.xpm
WE ./textures/brick_wall_with_frame.xpm
EA ./textures/brick_wall_2.xpm
SO ./textures/stone_wall.xpm
DO ./textures/door.xpm
SK ./textures/skybox.xpm
TH ./textures/memli_man.xpm
BA ./textures/battery.xpm

F 50,50,50
C 225,30,0

111111111111111111111111111111111111111111111111111111111111111111111111111111111
100000000000100010000000100010000000000000001000000010000000000000001000000000001
1E00000000001000100000001000100000000000000010000000100000000000000010000000B0001
100000000000100010000000100010000000000000001000000010000000000000001000000000001
111111311111100010001111100010001111111110001000000010001000100011111000111110001
100000001000000000001000000010001000000000001000000000001000100000000000000010001
100000001000000000001000000010001000000000001000000000001000100000000000000010001
100000001000000000001000000010001000000000001000000000001000100000000000000010001
111110001000111110001000111110001111100010001000111110001111111110001000100010001
100000000000000010001000100000000000100010001000000000000000100010001000100010001
100000000000000010001000100000000000100010001000000000000000100010001000100010001
100000000000000010001000100000000000100010001000000000000000100010001000100010001
100011111111100010001000100011111000100011111000111111111000100010001111111111111
100010000000000010001000000010000000000000001000100010000000100000000000100010001
100010000000000010001000000010000000000000001000100010000000100000000000100010001
100010000000000010001000000010000000000000001000100010000000100000000000100010001
100010001000111110001000111111111000000010001000100010001111100011111000100010001
100000001000100000000000100000001000000010001000000010000000100010000000000000001
100000001000100000000000100000001000000010001000000010000000100010000000000000001
100000001000100000000000100000001000000010001000000010000000100010000000000000001
100000001000111110001000100011111000100011111000111110001111111111111000111110001
100000001000000000001000000000001000100000000000100000001000000010001000100000001
1000000010000000000010000000000010001000000000001000000010B0000010001000100000001
100000001000000000001000000000001000100000000000100000001000000010001000100000001
111110001000111111111000111111111000111111111000111110001111100010001111111110001
100000001000100010000000100010000000100010001000000010001000000000000000000000001
100000001000100010000000100010000000100010T01000000010001000000000000000000000001
100000001000100010000000100010000000100010001000000010001000000000000000000000001
111111111000100010001000100011111000100010001111100010001000100011111000111110001
100010000000000000001000100000001000000010001000000010000000100010000000100010001
100010000000000000001000100000001000000010001000000010000000100010000000100010001
100010000000000000001000100000001000000010001000000010000000100010000000100010B01
100010001111111110001111100000001111100010001111100011111000111110001000100011111
100000000000000010000000000000000000000010000000000000000000000010001000100000001
100000000000000010000000000000000000000010000000000000000000000010001000100000001
100000000000000010000000000000000000000010000000000000000000000010001000100000001
111110001111100010001000111111111000100010001111100011111000100010001111100010001
100000000000100010001000000000001000100010001000100000001000100010000000100010001
10000000000B100010001000000000001000100010001000100000001000100010000000100010001
100000000000100010001000000000001000100010001000100000001000100010000000100010001
100000001111111111111000111110001111100011111000100011111000100010000000100011111
100000000000100000000000000000001000000000000000000000001000000000000000000000001
100000000000100000000000000000001000000000000000000000001000000000000000000000001
100000000000100000000000000000001000000000000000000000001000000000000000000000001
100011111111111111111000000011111111100010000000111110001000100011111111100010001
100000001000000010001000000010001000000010000000000010001000100010001000000010001
1000000010000000100010000000100010B0000010000000000010001000100010001000000010001
100000001000000010001000000010001000000010000000000010001000100010001000000010001
111110001000111110001111100010001111111111111000111110001000100010001111100010001
100010000000000010000000100000001000100000000000100010001000000000001000100000001
10B010000000000010000000100000001000100000000000100010001000000000001000100000001
100010000000000010000000100000001000100000000000100010001000000000001000100000001
100010000000111110001111100010001000111110001000100010001111100011111000111110001
100000000000000000000000100010000000000010001000100000000000100000000000100000001
100000000000000000000000100010000000000010001000100000000000100000000000100000001
100000000000000000000000100010000000000010001000100000000000100000000000100000001
111110001111100010000000111111111000100011111111111111111111111111111000100000001
100000001000000010000000000000000000100010001000100010001000000000000000100000001
10000000100000001000000000000000000010B0100010001000100010B0000000000000100000001
100000001000000010000000000000000000100010001000100010001000000000000000100000001
100010001111111110001000111111111000111110001000100010001111111111111000100011111
100010000000000010001000100010001000000000000000100010000000000000001000000000001
100010000000000010001000100010001000000000000000100010000000000000001000000000001
100010000000000010001000100010001000000000000000100010000000000000001000000000001
100010001000000011111000100010001111100011111111100010001111111111111111100010001
100000001000000000000000100010000000000000001000100000001000100000001000000010001
1000000010000000000000001000100000000000000010001000000010B0100000001000000010001
100000001000000000000000100010000000000000001000100000001000100000001000000010001
100011111111100011111000100011111111111111111000100011111000100000001111111110001
100000001000000000001000000000000000000000001000100000000000100000001000000000001
100000001000000000001000000000000000000000001000100000000000100000001000000000001
100000001000000000001000000000000000000000001000100000000000100000001000000000001
100000001111111110001000100000001111111110001000100010001000100010001000100011111
100000000000100010000000100000001000100010001000000010001000000010001000100000001
1000000000B0100010000000100000001000100010001000000010001000000010001000100000001
100000000000100010000000100000001000100010001000000010001000000010001000100000001
100011111111100010001000100011111000100010001000100010001000111111111000113111111
100000000000000010001000000000000000000000000000100000001000100000000000100000001
100000000000000010001000000000000000000000000000100000001000100000000000100000001
100000000000000010001000000000000000000000000000100000001000100000000000100000001
111111111111111111111111111111111111111111111111111111111111111111111111111111411
