NO ./textures/brick_wall.xpm
WE ./textures/brick_wall_with_frame.xpm
EA ./textures/brick_wall_2.xpm
SO ./textures/stone_wall.xpm
DO ./textures/door.xpm
SK ./textures/skybox.xpm
TH ./textures/memli_man.xpm
BA ./textures/battery.xpm

F 50,50,50
C 225,30,0

1111111111111111111111111111111
1000000B100010100000001000001S1
1011111110111010101010111011131
1000001010100000101010000010001
1011101010111011111110111010101
1000101010000000101000101B10101
1110101010101110101111101110111
1000000010100010000000100010001
1011101110111011111010111010001
100B101000100010001010100000001
1011101110111111101110111011101
100000101000100010000010000B101
1110001010101010111110111110111
1B00000000100010001000101000001
1111101110101010111011101011111
100000001010101T000000001010001
1011111011111110111110111010111
101B100000001000000010000000001
1010111000111111101110111000111
1000001000100010000000100000001
1110101011111010111111101011101
10001000100000001000000010001B1
1011101010111111101111101110111
1010101010000000000010100000001
1110101110111010111010111111101
1020000010001010101010001000101
1010111011101011101010001010101
1010101000000010100000000010101
1011101011101110111110001010101
1004100000100B10000000001010001
1111111111111111111111111111111
