NO ./textures/brick_wall.xpm
WE ./textures/brick_wall_with_frame.xpm
EA ./textures/brick_wall_2.xpm
SO ./textures/stone_wall.xpm
DO ./textures/door.xpm
SK ./textures/skybox.xpm
TH ./textures/memli_man.xpm
BA ./textures/battery.xpm

F 50,50,50
C 225,30,0

111111111111111111111111111111111111111111111111111111111111111111111111111111111
1E0000100000001000101000101010100000001010000000101000100010100010001B00100000001
111010101000101110101011101010111111101011100000101011101010111010101011100011111
100010101000101000000010000010000000101000000000001000001000100000100000000000101
111110101011101110111110111110101011101111101110111010111110101011111111101110101
100010000010100010001000001000101010000000001000101010001010001010001000101010101
111010100010101110111110101011101111111011111110101011101011101010001110101011101
100000100000100000001000101000101000100000100010000010101000101010000010101000001
101111111111101110101110101110111011101111100011101110101110101111111010101011101
1000100000100010101000100010001B0000101010100000100000100010101000001000001010001
111110101010111011101010001110111010101010101110111000101110111110111011101010111
1000001010101000001010000000000000100000100010000000000010101000000010001010100B1
101110111111101000101010111011111010111111101110101110111010101110101011101010111
101000000010001000001010100000100010000010000010100000001010000010101010000000001
101110101010001011101011101111100011101111111111111011101010101011101111111011101
101000101010000010000010101000000010000000100000001000001000101010000000100010101
101010111010111010001010111111111011111011111011101111101110101010001110100010101
100010001000000010001000101000000010000010100000101000101000000000000000000000001
1B1110001110101111111010101010111011101110111010101110101111111000111111111110111
101010001010100000000010001010001000001000000010100010100000000000000010100000101
101011111010101111111110111010111011111010111011111010101111101111101110101000101
100010101010001010001010001000101000001010101010100000000000100010100B10001000101
101110101011101011101011111111101011111010101010111011111011111110101110101011101
100000001010101000000010001000100000101010000000000000001000100000000000101000001
101110001010101110111110111011111010101010001111101011111011111011101000111011111
10100000100010001000000000001000001000001000101000100000100000000B101000001000001
101111111000111011101011111010111011111110111011101011111010111110111111101110101
100000100000000000101000000000001010100000000000000000001010100000000010001000101
101110101010101111111111111111111010111000001110001110101011101110101110111010101
100000101010100010000000100000000000000000000010000000101010001000101010001010101
101110111010101110101111111111111011101111111011111011111111101111111010111011111
100010001010001000100010000010100010000000100000001000100000100000100000100000001
101011101110111110101011101010111011111111111111101011100011111011111010111110111
1010001000101010101010001010000010101B10101000101000000000101000000B1010000010001
11111010111110101110100B101110111010101010101010111011101010100010111011101110111
100000000010000010001000100010100010000000101000001000001010100010000010001000001
111010111010100010101011101110111111101111111011101000111010111011101110101111101
100010001010100010100000100000101000001000100010000000100010001010000010101000101
101110111110111111100011111110101010111011101011111011111011101110101110111110101
100000101000001000100010000000000010001010001000001000000000100000101010000010001
111110101110111110101010001011111111101010111110101111111000111010111010001010111
100010000010000000101000001000000010001000001000100010001000001010100010001000001
101011101111101111101010101110001111101010111111100010111110111111100010001011101
1B1000001000101000000010100000000000000010001000100000001010000010000010000000001
111010111010101110101111101110100010111011101011101010111010101110001110100011101
100010101010100000100000000010100010001T10101000001010000000100000001000100000001
111011101011101011111110111111101111111010111011101011100010111111111111111111101
101000100010001000000010101000101000101000001000101000000010100000000000100000101
101110101010111010111010101010101110101011101011101110101110111110101111100011101
101000001000001010000010001010000000100000100010000000100010000000101000000000101
101111101111101111101111111111101010111011111010111111101111111110101000101011111
100010000000001000000010000010001010101010000000100000001000000000101000101000001
101110111011111111111010111010101011101011111110111011111111101011101010111110001
100000100010000000000010101010101000100000001000000010001000001010001010001000001
111011111010111111101111101010111011101111111011111010101011111010111010101111111
1000100010101000001000000010000000000000101010001010101000101000000000001010000B1
101110111010100011101010001011111111111010101011101011111010111011101000101011101
100000000010100000101010000000001010000010001000101010000010000010001000001010001
101111111011111011101010101111111011101110101010101010111010111110111011101110111
100B10000000000000000010100010000000100000100010000000100000001000001000101010001
101010111110111111101111111010111011101110111011101110111110111011111111111010111
101010001010001000000010001000100000100010000010000010000000001010000000100010101
101011111011111011101110101111101111111010101111111110111110111110101111101110101
100000100010100010100010100010100010100000100000000000000010000000100000001000001
111110101010101110100010111010111110111011100011101111101110001110100010101011111
1010000010101010001000000000B0001000000000100010101000101000001000100010100000101
101110101110111010101011111111101110111011111010111011101110111111101110111010101
101000100010000010101010000000001010101010101000001010100000100000100010100010001
101010111010111011101110001110111010101010101111101010111110111011111110101010111
100010001010000000000010001000001000100000100000001010001010101010101000101000001
111011111010101110111110101011111010101110111011101010111010101010101111101111101
100000001010101010100000101000001010001000000000101000100000001000000000000000001
101110111011111010101010111110001111101011111111101010100010111111111000101000111
100010001000100010001010100000001000101010101000101010100010100010100000101000001
111010111011101010101110111110111110101010101010101011111010111010111110101111101
100010001000001010100000000010100010001010001010100010000010001010000000101000101
101011101010101111111110101011111010111110111110101111101111101011101111111011101
101000000010101010000000101000000010100010000010101B00001000001000000000100000001
101110101011101010001011111110111011101011101110101110111010101110111011101010131
100B10101000101000001000000000001010001000000000000000000010100000001000101010101
111111111111111111111111111111111111111111111111111111111111111111111111111111141
