NO ./textures/brick_wall.xpm
WE ./textures/brick_wall_with_frame.xpm
EA ./textures/brick_wall_2.xpm
SO ./textures/stone_wall.xpm
DO ./textures/door.xpm
SK ./textures/skybox.xpm
TH ./textures/memli_man.xpm
BA ./textures/battery.xpm

F 50,50,50
C 225,30,0

1111111111111111111111111111111111111111111111111111111111111
1000000000001000100010000000000010000000000000001000000000001
100000S000001000100010000000000010000000000000001000000000001
1000000000001000100010000000000010000000000000001000000000001
1111113111111000100010001000100011111111100010001000111110001
1000000010B01000100000001000100000000000100010001000100000001
10000000100010001000000010001000000000001000100010B0100000001
1000000010001000100000001000100000000000100010001000100000001
1000111110001000111111111000100011111000100010001111100011111
1000100010001000000000000000100000000000000000001000100010001
1000100010001000000000000000100000000000000000001000100010001
1000100010001000000000000000100000000000000000001000100010001
1000100010001000100011111111100011111111111110001000100010001
1000100000000000100010000000100000001000000010000000000000001
1000100000000000100010000000100000001000000010000000000000001
1000100000000000100010000000100000001000000010000000000000001
1000100011111111111111111000111110001111100011111000111111111
1000000000000000100000000000100000001000000000000000000000001
100000000000000010B000000000100000001000000000000000000000001
1000000000000000100000000000100000001000000000000000000000001
1000111111111111111111111000111110001111100011111111100000001
1000000010001000000000001000000000000000100000000000000000001
1000000010001000000000001000000000000000100000000000000000001
1000000010001000000000001000000000000000100000000000000000001
1000111110001000000010001000111111111000100010001111111110001
1000100000000000000010000000000000000000000010001000000010001
1000100000000000000010000000000T00000000000010001000000010B01
1000100000000000000010000000000000000000000010001000000010001
1000111110001000000010001111111111111111100010001000000011111
1000100000001000000010000000000010000000000010001000000000001
1000100000001000000010000000000010000000000010001000000000001
1000100000001000000010000000000010000000000010001000000000001
1000111110001111111110001111100010000000111111111000100011111
1000100000001000100000000000000010000000000010000000100000001
1000100000001000100000000000000010000000000010000000100000001
1000100000001000100000000000000010000000000010000000100000001
1000100010001000111110001000111110001111100010001111111110001
1000000010001000100000001000100000001000000010001000100000001
1000000010B0100010000000100010B000001000000010001000100000001
1000000010001000100000001000100000001000000010001000100000001
1111100011111000111110001000111110001000100010001000111110001
1000000000001000000010001000000000001000100000000000100010001
1000000000001000000010001000000000001000100000000000100010001
1000000000001000000010001000000000001000100000000000100010001
1000111111111000111110001000111110001000100010001111100011111
1000100000000000000000001000100000001000100010001000100010001
1000100000000000000000001000100000001000100010001000100010B01
1000100000000000000000001000100000001000100010001000100010001
1000100011111000111111111000100011111111111110001000100010001
1000000010000000100000000000100000001000100000000000000000001
1000000010000000100000000000100000001000100000000000000000001
1000000010000000100000000000100000001000100000000000000000001
1000111110001111100011111111111110001000100011111000111110001
1000000010001000000000000000100010001000000000000000000010001
1000000010001000000000000000100010001000000000000000000010001
1000000010001000000000000000100010001000000000000000000010001
1111111110001000100011111000100010001000100010001111111111111
1000000010000000100010000000000000000000100010000000000000001
400000002000000010001000000000000000000010B010000000000000001
1000000010000000100010000000000000000000100010000000000000001
1111111111111111111111111111111111111111111111111111111111111
