NO ./textures/brick_wall.xpm
WE ./textures/brick_wall_with_frame.xpm
EA ./textures/brick_wall_2.xpm
SO ./textures/stone_wall.xpm
DO ./textures/door.xpm
SK ./textures/skybox.xpm
TH ./textures/memli_man.xpm
BA ./textures/battery.xpm

F 50,50,50
C 225,30,0

1111111111111111111111111111111111111111111111
1000001000001000000001000001000000000001S00001
100B0010000010000000010000B1000000000001000001
1000001001001001111111001111000001001111111311
1000001001000000000001000000000001000000001001
1000001001000000000001000000000001000000001001
1001111111000001001111001001001001111001111001
1001001000000001001B00001001001001001001001001
1001001000000001001000001001001001001001001001
1001001111111111001111001001111111001001001001
1001000000000000001000001000000001000000000001
1001000000000000001000001000000001000000000001
1001111001001001111001111001111111000001111001
1000000001001001000000001000000001000000001001
1000000001001001000000001000000001000000001001
1111111111001001111111001111001001001111111001
1B00000000001000000001001000001001000001B00001
1000000000001000000001001000001001000001000001
1111001111111001001001111001001111111001111001
1000001000000001001001001001000000001000001001
1000001000000001001001001001000000001000001001
1001111000001111001001001001111111001001111001
1000000000000001001000000001000000000000000001
1000000000000001001000T00001000000000000000001
1000001000001111001111001001001111111111001111
1000001000001000001000001000000001000000000001
1000001000001000001000001000000001000000000001
1001111001001001111111111001000001111000001001
1000000001001000001000000001000001000000001001
10000000010010000B1000000001000001000000001001
1001111111001111111111001111001111111001001001
1000001001000001000000000001001001000001000001
1000001001000001000000000001001001000001000001
1001111001111001111001001111111001111111001111
1000000001001000000001000001001000001001000001
1000000001001000000001000001001000001001000001
1001111001001111111111111001001111001001001001
1000000000001001000000001000001001000001001001
1000000000001001000000001000001001000001001B01
1111001111001001000001111001001001001111111111
1000001000000000000000001001000000001001000001
1000001000000000000000001001000000001001000001
1001001111001000001001111001111111001001001001
1B01001000001000001000000001000000000000001001
1001001000001000001000000001000000000000001001
1111111111111111111111111111111111111111111441
