NO ./textures/brick_wall.xpm
WE ./textures/brick_wall_with_frame.xpm
EA ./textures/brick_wall_2.xpm
SO ./textures/stone_wall.xpm
DO ./textures/door.xpm
SK ./textures/skybox.xpm
TH ./textures/memli_man.xpm
BA ./textures/battery.xpm

F 50,50,50
C 225,30,0

        1111111
111111111000001
1B0000001113111
1B0B0011000000011
1B0001000000000001   11111
1B00100000000000001  10001
10002000000S0000001  10001
1B00100000000000001  11111
100001000000000001
100B00110000000111111111111
111111111113111100000000001
       10000000100000000001
       10000000100000000001
       100000001000000T0001
       10000000100000000001
       10000000100000000001
       10000000100000000001
       11114111111111111111


